Field A-1
11 11
<^^^^^^^^^>
,#########/
,# 1 #$  #/
,#       #/
,# ####  #/
,# #$ ##$#/
,# #   ###/
,#   #o  #/
,#   #  2#/
,#########/
v_________V