Field A-3
11 9
<^^^^^^^^^>
,###$#####/
,# # #  $#/
,# #   o##/
,#1# ##  #/
,# # #$#2#/
,#  o    #/
,#########/
v_________V