Field B-2
14 12
<^^^^^^^^^^^^>
,### ########/
,$   #$#    #/
,$o#o  #    #/
,$     # #o #/
,#   #o2 # o#/
,#.##o1o #  $/
,# $  o #$  #/
,# ## # $##$#/
, o     $####/
,############/
v____________V