Field B-1
9 9
<^^^^^^^>
,##$#$##/
,#  #  #/
,#  #  #/
,# 1#2 #/
,##.#.##/
,#     #/
,#$$#$$#/
v_______V