Field A-7
13 15
<^^^^^^^^$^^>
,$ o       $/
,# o #$# # #/
, o  ###   #/
,###oo $ # #/
,#    ####$#/
,# #### #$##/
,# # o o   $/
,# ## # #  #/
,# 1#o o o##/
,#o # # #  #/
,$  o # o  #/
,# #  #  o2#/
,#$#####$$##/
v___________V