Field A-6
16 15
<^^^^^^^^^^^^^>
,#$# #########/
,#     o #####/
,# # #$ o   ##/
,# o  $#  # ##/
,#   #$ o   ##/
,# #$##  # ###/
,# ###1o o #$#/
,# #$#####$# #/
,#  o   2##$ #/
,# $#o$####  $/
,# ##   o # o$/
,#  o #      #/
,#  $ ########/
v_____________V