Tutorial
9 9
<^^^^^^^>
,#######/
,#  12 #/
,#     #/
,#     #/
,#     #/
,#     #/
,#$$#$$#/
v_______V