Field A-2
14 11
<^^^^^^^^^^^^>
,############/
,#1#2      $#/
,# ###### ###/
,# o        #/
,### ###  ###/
,#   $#  o  #/
,# #### ## ##/
,# $#$   # $#/
,############/
v____________V