Field A-4
20 8
<^^^^^^^^^^^^^^^^^^>
,###$######$#######/
,#               1#/
,###o##### o#### ##/
,#   #   #o     o #/
,#2  o      #  #  #/
,###############$##/
v__________________V