Field A-5
14 15
<^^^^^^^^^^^^>
,############/
, #   o #####/
, # #$ o   ##/
, # ### ## ##/
, # #$ o   ##/
, # ## ## ###/
, # #1o o #$#/
,## ### #$# #/
,# o   2##$ #/
,###o$####  $/
,###   o # o$/
,  o #      #/
,##$ ########/
v____________V